b	ㅂ
bʱ	ㅍ	
ɕ	ㅅ	
ɕ͈	 ㅆ	
d	ㄷ	
dʱ	ㅌ	
dʑ	ㅈ	
dʑʱ	ㅊ	
ɡ	ㄱ	
ɡʱ	ㅋ	
h	ㅎ		
ɦ	ㅎ	
j	ㅖ, ㅒ, ㅑ, ㅛ, ㅠ, ㅕ	
k	ㄱ, ㅋ	
k͈	ㄲ	
kʰ	ㅋ, ㅎㄱ		
l	ㄹ, ㄴ	
m	ㅁ, ㅂ	
n	ㄴ, ㄹ, ㄷ, ㅅ, ㅈ	
ŋ	ㅇ, ㄱ	
p	ㅂ, ㅍ	
p͈	 ㅃ	
pʰ	ㅍ, ㅎㅂ		
ɾ	ㄹ	
s	ㅅ	
s͈	 ㅆ	
t	ㄷ, ㄷ, ㅌ, ㅅ, ㅈ, ㅊ, ㅎ
tʰ	ㅌ, ㅎㄷ	
tɕ	ㅈ
tɕ͈	 ㅉ
tɕʰ	ㅊ, ㅎㅈ		
w	ㅜ, ㅗ	